7 7 7 7 7 7 6 6 6 7 7 7 7 7 7 7 7 7 7 7 7 7 7 7 7 7 7 6 6 6 6 6 6 7 9 7 7 7 7 7
7 7 7 7 7 7 9 9 9 7 7 7 7 7 7 7 7 7 7 7 7 7 7 7 7 7 7 9 9 9 9 9 9 7 9 7 7 7 7 7
7 7 7 7 7 7 9 9 9 7 7 7 7 7 7 7 7 7 7 7 7 7 7 9 9 9 9 9 9 9 9 9 9 7 9 7 7 7 7 7
7 7 7 7 7 7 9 9 9 7 7 7 7 7 7 7 7 7 7 7 7 7 7 9 9 9 9 9 9 9 9 9 9 7 9 7 7 7 7 7
7 7 7 7 7 7 9 9 9 9 9 9 9 7 7 7 7 7 7 9 9 9 9 9 9 9 9 9 9 9 9 9 9 7 7 7 7 7 7 7
7 7 7 7 7 7 9 9 9 9 9 9 9 7 7 7 7 7 7 9 9 9 9 9 9 9 9 9 2 2 2 2 7 7 2 2 2 2 2 2
7 7 7 7 7 7 9 9 9 9 9 9 9 9 9 9 9 9 9 9 9 9 9 9 9 9 9 2 2 2 2 2 7 7 2 2 2 2 2 2
7 7 7 7 7 7 9 9 9 9 9 9 9 9 9 9 9 9 9 9 9 9 9 9 9 2 2 2 2 2 7 7 9 9 9 9 9 9 9 9
7 7 7 7 9 1 1 9 9 9 9 9 9 9 9 9 9 9 9 9 9 9 9 2 2 2 2 2 2 2 7 7 7 7 7 7 7 7 7 7
7 7 7 7 1 1 1 1 9 9 9 9 9 9 9 9 9 9 9 9 9 2 2 2 2 2 2 2 9 9 7 7 7 7 7 7 7 7 7 7
7 7 7 7 7 7 1 1 9 9 9 9 9 9 9 9 9 9 9 9 9 2 2 2 2 2 9 9 1 1 7 7 7 7 7 7 7 7 7 7
7 7 7 7 7 7 1 1 9 9 9 9 9 9 9 9 9 9 9 9 9 2 2 2 2 2 9 1 1 0 1 1 7 7 7 7 7 7 7 7
7 7 7 7 7 7 1 1 1 1 9 9 9 9 9 9 9 9 9 9 9 2 2 2 9 9 9 1 1 9 1 1 7 7 7 7 7 7 7 7
7 7 7 7 7 7 1 1 1 1 9 9 9 9 9 1 1 9 9 9 6 2 2 2 6 9 9 1 1 1 1 1 7 7 7 7 7 7 7 7
7 7 7 7 7 7 1 1 1 1 9 9 9 9 1 1 1 9 9 9 9 2 2 2 9 9 9 1 1 1 1 1 7 7 7 7 7 7 7 7
7 7 7 7 7 7 1 1 1 9 9 9 9 9 1 1 1 9 9 9 9 2 2 2 9 9 9 1 1 1 1 9 7 7 7 7 7 7 7 7
6 9 9 9 9 9 9 9 9 9 9 9 9 9 7 7 7 7 9 9 7 2 2 2 7 9 1 7 7 7 7 7 7 7 7 7 7 7 7 7
6 9 9 9 9 9 9 9 9 9 9 9 9 9 7 7 7 7 9 9 7 2 2 2 7 7 7 7 7 7 7 7 7 7 7 7 7 7 7 7
7 7 7 7 9 9 9 9 9 9 9 9 7 7 7 7 7 9 9 1 7 2 2 2 7 7 7 7 7 9 9 7 7 7 7 7 7 7 7 7
7 7 7 7 9 9 9 9 9 9 9 9 7 7 7 7 7 9 1 1 7 2 2 2 2 9 9 9 9 9 9 7 7 7 7 7 7 7 7 7
7 7 7 7 1 9 9 9 9 9 9 9 7 7 7 7 7 1 1 1 7 2 2 2 2 9 9 9 9 9 9 9 9 7 7 7 7 7 7 7
7 7 7 7 1 1 9 9 9 9 9 1 7 7 7 7 7 1 1 1 7 2 2 2 2 0 9 9 9 9 9 9 9 7 7 7 7 7 7 7
7 7 7 1 1 1 1 9 9 9 9 1 7 7 7 7 7 1 1 1 7 2 2 2 2 9 9 9 9 9 9 7 7 7 7 7 7 7 7 7
7 7 7 1 1 1 1 9 9 9 1 1 7 7 7 7 7 1 1 9 7 2 2 2 2 2 2 2 2 2 2 7 7 7 7 7 7 7 7 7
7 7 7 1 1 1 1 9 9 9 1 1 7 7 7 7 7 1 9 9 7 2 2 2 2 2 2 2 2 2 2 7 7 2 2 2 2 2 2 2
7 7 7 1 1 1 1 9 9 9 1 1 7 7 7 9 9 1 9 7 7 2 2 2 2 2 2 2 2 2 2 7 7 2 2 2 2 2 2 2
7 7 7 7 7 7 7 9 9 9 1 1 7 7 7 9 1 9 9 7 2 2 2 2 2 2 2 2 2 2 2 2 9 7 7 7 7 7 7 7
7 7 7 7 7 7 7 9 9 1 1 1 7 7 7 1 9 9 7 7 2 2 2 2 2 2 2 2 2 2 2 2 2 7 7 7 7 7 7 7
7 7 7 7 7 7 7 7 7 7 7 7 7 7 7 9 9 9 7 9 9 2 2 2 2 2 2 2 2 2 2 2 2 7 7 7 7 7 7 7
7 7 7 7 7 7 7 7 7 7 7 7 7 7 7 9 9 7 7 9 9 9 2 2 2 2 2 2 2 2 2 2 2 7 7 7 7 7 7 7
7 7 7 7 7 7 7 7 7 7 7 7 7 9 9 9 1 1 1 9 9 9 9 2 2 2 2 2 2 2 2 2 2 7 7 7 7 7 7 7
7 7 7 7 7 7 9 7 7 7 7 7 7 9 1 1 1 1 1 1 9 9 9 9 2 2 2 2 2 2 9 9 9 7 7 7 7 7 7 7
7 7 7 7 7 7 7 7 7 7 7 7 9 1 1 1 9 1 1 1 9 9 9 9 9 2 2 2 2 2 9 9 1 7 7 7 7 7 7 7
7 7 7 7 7 7 7 7 7 7 7 7 1 1 1 1 1 1 1 0 1 9 9 9 9 9 2 2 2 2 9 1 9 7 7 7 7 7 7 7
7 7 7 7 7 7 7 7 7 7 7 7 7 7 7 7 7 7 1 9 1 1 9 9 9 9 9 9 9 9 9 1 1 7 7 7 7 7 7 7
7 7 7 7 7 7 7 7 7 7 7 7 7 7 7 7 7 7 1 1 1 1 9 9 9 9 9 9 9 9 1 1 1 7 7 7 7 7 7 7
7 7 7 7 7 7 7 7 7 7 7 7 7 7 7 7 7 7 1 9 1 1 1 9 9 9 1 9 1 1 1 9 1 7 7 7 7 7 7 7
7 7 7 7 7 7 7 7 7 7 7 7 7 7 7 7 7 7 1 1 9 1 9 9 9 9 1 1 1 1 1 1 1 7 7 7 7 7 7 7
7 7 7 7 7 7 7 7 7 7 7 7 7 7 7 7 7 7 7 7 7 7 7 7 7 7 7 7 7 7 7 7 7 7 7 7 7 7 7 7
7 7 7 7 7 7 7 7 7 7 7 7 7 7 7 7 7 7 7 7 7 7 7 7 7 7 7 7 7 7 7 7 7 7 7 7 7 7 7 7
