7 7 7 7 7 7 7 7 7 7 7 7 7 7 7 7 7 7 7 7 7 7 7 7 7 7 7 7 7 6 6 7 7 7 7 7 7 7 7 7
7 7 7 7 7 7 7 7 7 7 7 7 7 7 7 7 7 7 7 7 7 7 7 7 7 7 7 7 7 9 9 7 7 7 7 7 7 7 7 7
7 7 7 7 7 7 7 7 7 7 7 7 7 7 7 7 7 7 7 7 7 7 7 7 7 7 9 9 9 9 9 7 7 7 7 7 7 7 7 7
7 7 7 7 7 7 7 7 7 7 7 7 7 7 7 7 7 7 9 9 9 9 9 9 9 7 9 9 9 9 9 7 7 7 7 7 7 7 7 7
7 7 7 7 9 9 9 9 7 7 7 7 7 9 9 9 9 7 9 9 9 9 9 9 9 7 9 9 9 9 9 9 9 9 9 9 9 7 7 7
7 7 7 7 9 9 9 9 7 7 7 7 7 9 9 9 9 7 9 9 9 9 9 9 9 7 9 9 9 9 9 9 9 9 9 9 3 7 7 7
7 7 9 9 9 9 9 9 7 3 9 9 9 9 9 9 9 7 9 9 9 9 9 9 9 7 9 9 9 9 9 9 9 9 9 9 9 7 7 7
7 7 9 9 9 9 9 9 7 9 9 9 9 9 9 9 9 7 9 9 9 9 9 9 9 7 9 9 9 9 9 9 9 7 7 7 7 7 7 7
7 7 9 9 9 1 1 1 7 9 9 9 9 9 9 9 7 7 9 9 9 9 9 9 9 7 7 7 9 9 9 9 9 7 7 1 1 1 7 7
7 7 9 9 1 1 1 1 7 7 7 7 7 9 9 7 7 7 9 9 9 9 9 9 9 9 9 9 9 9 9 1 1 1 1 1 1 1 7 7
7 7 7 7 7 7 1 1 1 1 9 9 9 9 9 9 9 3 9 9 9 9 7 7 7 7 7 7 9 9 9 1 1 1 1 1 1 1 7 7
7 7 7 7 7 7 1 1 1 1 1 9 9 9 9 9 9 9 9 9 9 9 7 7 7 7 7 7 9 9 9 9 1 1 1 1 1 1 7 7
7 7 7 7 7 7 1 1 1 1 1 1 9 9 9 9 9 9 9 9 9 7 7 7 7 7 7 7 7 3 9 9 9 1 1 1 7 7 7 7
7 7 7 7 7 7 1 1 1 1 1 1 9 9 9 9 9 9 9 9 9 7 7 7 7 7 7 7 7 9 9 9 9 9 9 1 7 7 7 7
7 7 7 7 7 7 1 1 1 1 1 1 9 9 9 9 9 9 9 9 9 9 9 9 9 9 9 9 9 9 9 9 9 9 9 3 7 7 7 7
7 7 7 7 7 7 1 1 1 9 7 7 7 7 9 9 9 9 9 9 9 9 9 9 9 9 9 9 9 9 9 9 9 9 9 9 7 7 7 7
7 7 7 7 7 7 9 9 9 9 7 7 7 7 9 9 9 9 9 9 9 9 9 9 9 9 9 9 9 9 9 9 9 9 9 9 9 9 9 6
7 7 7 7 7 7 3 9 9 9 7 7 7 7 9 9 9 9 9 9 9 9 9 9 9 9 9 9 9 9 9 9 9 9 9 9 9 9 9 6
7 7 7 7 3 9 9 9 9 9 7 7 7 7 7 7 9 9 9 9 9 9 7 7 7 7 7 7 7 7 7 7 7 7 7 7 7 7 7 7
7 7 7 7 9 9 9 9 9 9 7 7 7 7 7 7 9 9 9 9 9 9 7 7 7 7 7 7 7 7 7 7 7 7 7 7 7 7 7 7
6 9 9 9 9 9 9 9 7 7 7 7 7 7 7 7 9 9 9 9 7 7 7 7 7 7 7 7 7 7 7 7 7 7 7 7 7 7 7 7
6 9 9 9 9 9 9 9 7 7 7 7 7 7 7 7 9 9 9 9 7 7 7 7 7 7 7 7 7 7 7 7 7 7 7 7 7 7 7 7
7 7 7 7 7 7 7 7 7 7 7 7 7 7 7 7 9 9 9 9 9 7 7 7 7 7 7 7 7 7 7 7 7 7 7 7 7 7 7 7
7 7 7 7 7 7 7 7 7 7 7 7 7 7 7 7 9 9 9 9 9 7 7 7 7 7 7 7 7 7 7 7 7 7 7 7 7 7 7 7
7 7 7 7 7 7 7 7 7 7 7 7 7 7 7 7 9 9 9 9 9 9 9 9 9 9 9 7 7 7 7 7 7 7 7 7 7 7 7 7
7 7 7 7 7 7 7 7 7 7 7 7 7 7 7 7 9 9 9 9 9 9 9 9 9 9 9 7 7 7 7 7 7 7 7 7 7 7 7 7
7 7 7 7 7 7 7 7 7 7 7 7 7 7 9 9 9 9 9 9 9 9 9 9 9 9 9 9 9 9 9 7 7 7 7 7 7 7 7 7
7 7 7 7 7 7 7 7 7 7 1 1 1 9 9 9 9 9 9 9 9 9 1 1 1 9 9 9 9 9 9 7 7 7 7 7 7 7 7 7
7 7 7 7 7 7 1 1 1 1 1 1 1 9 9 9 9 9 9 9 1 1 1 1 1 1 9 9 9 9 9 9 3 7 7 7 7 7 7 7
7 7 7 7 7 7 1 1 1 1 1 1 9 9 9 9 9 9 9 9 1 1 1 1 1 1 1 9 9 9 0 0 0 0 0 0 0 0 0 0
7 7 7 7 1 1 1 1 1 1 1 9 9 9 9 9 9 9 9 1 1 1 1 1 0 1 1 1 9 9 0 0 0 0 0 0 0 0 0 0
7 7 7 7 1 1 1 1 1 1 9 9 9 9 9 9 9 9 9 1 1 1 1 1 9 1 1 1 9 9 0 0 0 0 0 0 0 0 0 0
7 7 7 7 1 1 1 9 9 9 9 9 9 9 9 9 9 9 9 1 1 1 1 1 1 1 1 1 9 9 0 0 0 0 0 0 0 0 0 0
7 7 7 7 9 9 9 9 9 9 9 9 9 9 9 9 9 9 9 9 1 1 1 1 1 1 1 1 9 9 0 0 6 0 0 0 0 0 0 0
7 7 9 9 9 9 9 9 9 9 7 7 7 7 9 9 9 9 9 9 9 9 1 1 1 1 9 9 9 9 9 9 9 7 7 7 7 7 7 7
7 7 3 9 9 9 9 9 9 9 7 7 7 7 9 9 9 9 9 9 9 9 9 9 9 9 9 9 9 9 9 9 9 7 7 7 7 7 7 7
7 7 9 9 9 9 9 3 7 7 7 7 7 7 7 7 9 9 9 9 9 9 9 9 9 9 9 9 9 9 9 9 9 7 7 7 7 7 7 7
7 7 9 9 9 9 9 9 7 7 7 7 7 7 7 7 9 9 9 9 9 9 9 9 9 9 9 9 9 9 9 9 9 7 7 7 7 7 7 7
7 7 7 7 7 7 7 7 7 7 7 7 7 7 7 7 7 7 7 7 9 9 9 9 9 9 9 3 7 7 7 7 7 7 7 7 7 7 7 7
7 7 7 7 7 7 7 7 7 7 7 7 7 7 7 7 7 7 7 7 9 9 9 9 9 9 9 9 7 7 7 7 7 7 7 7 7 7 7 7
