7 7 7 7 7 7 7 7 7 7 7 7 7 7 7 7 7 7 7 7 7 7 7 7 7 7 7 7 7 7 5 5 5 5 5 5 5 5 5 5
7 7 7 7 7 7 7 7 7 7 7 7 7 7 7 7 7 7 7 7 7 7 7 7 7 7 7 7 7 7 7 7 7 7 7 5 5 5 5 5
7 7 7 7 7 7 7 7 7 7 7 7 7 7 7 7 7 7 7 7 7 7 7 7 7 7 7 7 7 7 7 7 7 7 7 5 5 5 5 5
7 7 7 7 7 7 7 7 7 7 7 7 7 7 7 7 7 7 7 7 7 7 7 7 7 7 7 7 7 7 7 7 7 7 7 7 5 5 5 5
7 7 7 7 7 7 7 7 7 7 7 7 7 7 7 7 7 7 7 7 7 7 7 7 7 7 7 7 7 7 7 7 7 7 7 7 5 5 5 6
7 7 7 7 7 7 7 7 7 7 1 1 1 7 7 7 7 7 7 7 7 7 7 7 7 7 7 7 7 7 7 7 7 7 7 7 5 5 5 5
7 7 7 7 7 7 7 9 1 1 1 1 1 1 9 5 3 5 5 5 5 5 5 5 7 7 7 7 7 7 7 7 7 7 7 7 7 5 5 5
7 7 7 7 7 7 7 1 1 1 1 1 1 1 9 5 5 5 5 5 5 5 5 5 5 5 5 5 7 7 7 7 7 7 7 7 7 5 5 5
7 7 7 7 7 7 1 1 1 1 1 1 1 1 9 5 5 5 5 5 5 5 5 5 5 5 5 5 5 7 7 7 7 7 7 7 7 7 7 5
7 7 7 7 7 7 1 1 1 1 1 1 1 1 9 9 5 5 5 5 5 5 5 5 5 5 5 5 5 7 7 7 7 7 7 7 7 7 7 5
7 7 7 7 1 1 1 1 1 1 1 1 1 9 9 9 5 5 5 5 5 5 5 5 5 5 5 5 5 7 7 7 7 7 7 7 7 7 7 5
7 7 7 7 1 1 1 1 1 1 1 1 1 9 9 9 5 5 5 5 5 5 5 5 5 5 5 3 5 7 7 7 7 7 7 7 7 7 7 7
7 7 7 7 1 1 1 1 1 1 9 9 9 9 9 9 5 5 5 5 5 5 5 5 5 5 5 5 5 7 7 7 7 7 7 7 7 7 7 7
7 7 7 7 1 1 1 1 1 1 9 9 9 9 9 9 9 5 3 5 5 5 5 5 5 5 5 5 5 5 7 7 7 7 7 7 7 7 7 7
7 7 7 7 1 1 1 9 9 9 9 9 9 9 9 9 9 5 5 5 5 5 5 5 5 5 5 5 5 5 7 7 7 7 7 7 7 7 7 7
7 7 7 7 9 9 9 9 9 9 9 9 9 9 9 9 9 9 9 5 5 5 5 5 5 5 5 5 5 5 7 7 7 7 7 7 7 7 7 7
7 7 7 7 9 9 9 9 9 9 9 9 9 7 7 7 7 7 7 7 7 7 7 5 5 5 5 5 5 5 5 7 7 7 7 7 7 7 7 7
7 7 7 7 9 9 9 9 9 9 9 7 7 7 9 9 9 5 5 5 9 9 7 5 5 5 5 5 5 5 5 7 7 7 7 7 7 7 7 7
7 7 9 9 9 9 9 9 9 9 9 7 9 9 9 5 5 5 5 5 9 9 7 5 3 5 5 5 5 5 5 7 7 7 7 7 7 7 7 7
7 7 9 9 9 9 9 9 9 7 7 7 9 5 5 5 5 5 5 9 9 9 7 7 7 7 5 5 5 5 5 5 5 7 7 9 9 7 7 7
7 7 9 9 9 9 9 7 7 7 9 9 5 5 5 5 5 9 9 9 9 9 9 9 9 7 5 5 5 5 5 5 5 5 7 7 7 7 7 7
7 7 3 9 9 9 9 7 9 9 9 5 5 5 5 5 5 9 9 7 7 7 9 7 9 7 5 5 5 5 5 5 3 5 7 7 7 7 7 7
7 7 9 9 9 9 9 7 9 9 9 5 5 5 3 5 5 9 9 7 9 9 9 7 3 7 3 5 5 5 5 5 5 5 7 7 7 7 7 7
7 7 9 9 9 9 9 7 9 9 9 9 9 5 5 5 9 9 7 7 7 7 9 7 7 7 5 5 5 5 5 5 5 5 7 7 7 7 7 7
7 7 7 7 9 9 9 7 7 9 9 7 7 9 9 9 9 9 7 9 9 9 9 9 9 9 5 5 5 5 5 5 5 5 7 7 7 7 7 7
7 7 7 7 9 9 9 9 9 9 9 9 7 9 9 9 9 9 7 9 9 9 9 9 9 9 9 5 5 5 5 5 5 5 7 7 7 7 7 7
7 7 7 7 9 9 9 9 9 9 9 9 7 7 7 9 9 9 9 7 9 9 9 9 9 9 9 9 1 1 1 1 0 1 7 7 7 7 7 7
7 7 7 7 3 9 9 9 9 9 9 9 7 7 7 9 9 9 9 7 9 9 9 9 9 9 9 1 1 1 1 1 9 1 7 7 7 7 7 7
7 7 7 7 9 9 9 9 9 9 9 9 7 7 7 9 9 9 9 7 7 9 9 9 7 9 1 1 1 1 1 1 1 1 7 7 7 7 7 7
7 7 7 7 9 9 9 9 9 9 9 9 7 7 7 9 9 9 9 7 7 7 7 7 7 7 1 1 1 1 1 1 1 1 7 7 7 7 7 7
7 7 7 7 0 0 9 9 9 9 7 7 7 9 9 9 9 9 9 9 9 9 9 9 9 7 7 7 7 7 7 7 7 7 3 7 7 7 7 7
7 7 7 7 0 0 0 9 9 9 7 1 1 9 9 9 9 9 9 9 9 9 9 9 9 9 9 9 7 7 7 7 7 7 7 7 7 7 7 7
7 7 0 0 0 0 0 0 7 7 7 1 1 1 9 9 9 9 9 9 9 9 9 9 9 9 9 9 9 9 9 9 9 7 7 7 7 7 7 7
7 7 0 0 0 0 0 0 7 1 1 1 1 1 1 9 9 9 9 9 9 9 9 9 9 9 9 9 9 9 9 9 9 7 7 7 7 7 7 7
7 7 0 0 0 7 0 0 7 1 1 1 1 1 1 9 9 7 7 7 7 7 7 7 7 7 7 9 9 9 9 9 9 7 7 7 7 7 7 7
7 7 0 0 0 9 0 0 7 1 1 1 1 1 1 9 9 7 7 7 7 7 7 7 7 7 7 9 9 9 9 9 9 7 7 7 7 7 7 7
7 7 0 0 0 0 0 0 7 1 1 1 1 1 1 9 9 7 7 7 7 7 7 7 7 7 7 7 7 9 9 7 7 7 7 7 7 7 7 7
7 7 0 0 0 0 0 0 7 1 1 1 1 1 9 9 9 7 7 7 7 7 7 7 7 7 7 7 7 9 9 7 7 7 7 7 7 7 7 7
7 7 7 7 0 0 0 0 7 7 7 7 7 1 9 7 7 7 7 7 7 7 7 7 7 7 7 7 7 9 9 7 7 7 7 7 7 7 7 7
7 7 7 7 0 0 0 0 7 7 7 7 7 9 9 7 7 7 7 7 7 7 7 7 7 7 7 7 7 6 6 7 7 7 7 7 7 7 7 7
