5 7 5 5 5 5 5 5 5 7 7 7 7 7 7 7 7 7 7 7 7 7 7 7 7 7 7 7 7 7 7 7 7 7 7 7 7 7 7 7
5 7 5 5 5 5 5 5 5 7 7 7 7 7 7 7 7 7 7 7 7 7 7 7 8 8 8 8 8 8 8 8 8 8 8 7 7 7 7 7
5 8 5 5 5 5 5 5 5 7 7 7 7 7 7 7 7 7 7 7 7 7 7 7 8 7 7 7 7 7 7 7 7 7 8 7 7 8 8 8
5 7 5 5 5 5 5 5 7 7 7 7 7 7 7 7 7 7 7 7 7 7 7 7 8 7 7 7 7 7 7 7 7 7 8 7 7 8 7 8
6 7 5 5 5 5 7 8 7 7 7 7 7 7 7 7 7 7 7 7 7 7 7 7 8 7 7 7 7 7 7 7 7 7 8 7 7 8 7 8
5 7 5 5 7 7 7 8 7 7 7 7 7 7 7 7 7 7 7 7 7 5 7 7 8 7 7 7 7 7 7 7 7 7 8 8 8 8 7 8
5 7 5 7 7 9 7 8 7 7 5 7 7 7 7 7 5 5 5 5 5 5 5 5 5 5 5 5 5 5 5 5 7 7 7 7 7 7 7 8
5 7 7 7 9 9 7 5 5 5 5 5 5 5 5 5 5 7 7 7 7 7 7 7 7 7 7 7 7 7 5 5 7 7 7 7 7 7 7 8
5 7 7 7 7 9 7 5 5 5 5 5 5 5 5 7 7 7 9 9 9 1 1 1 1 1 1 1 1 7 5 5 7 7 7 7 7 7 7 8
5 9 7 7 7 9 7 5 5 5 5 5 5 5 5 7 9 9 9 9 1 1 1 1 1 1 1 9 9 7 9 9 7 7 7 7 7 7 7 8
7 7 7 7 7 9 7 5 5 5 5 5 5 5 7 7 9 9 9 9 9 9 9 9 9 9 9 9 9 9 9 9 9 7 7 7 7 7 7 8
7 7 7 7 7 7 7 5 5 5 5 5 5 5 7 9 9 9 9 9 9 9 9 9 9 9 9 9 9 9 9 9 9 7 7 7 7 7 8 8
7 7 7 7 7 7 5 5 5 5 5 5 5 5 7 9 9 9 9 9 9 9 9 9 9 9 9 9 9 9 9 9 9 7 7 7 7 7 7 7
7 7 7 7 7 7 5 5 5 5 5 5 5 5 7 9 9 9 9 7 7 7 7 7 7 7 9 9 7 9 9 9 1 7 7 7 7 7 7 7
7 7 7 7 7 7 5 5 5 5 5 5 5 7 7 9 9 9 9 7 7 7 7 7 7 7 9 9 7 7 9 1 1 7 7 7 7 7 7 7
7 7 7 7 7 7 7 7 7 9 7 7 5 7 9 9 9 9 9 7 7 7 7 7 7 7 9 9 9 7 7 7 1 7 7 7 7 7 7 7
7 7 7 7 7 7 7 9 9 9 9 7 5 7 9 9 7 7 7 7 7 7 7 7 9 9 9 9 9 9 9 7 1 7 7 7 7 7 7 7
7 7 7 7 7 7 7 9 9 9 9 7 5 7 9 9 7 9 9 9 7 7 7 7 9 9 9 9 9 9 9 7 1 7 7 7 7 7 7 7
7 7 7 7 7 7 7 7 7 7 7 7 7 7 9 9 7 9 9 9 9 9 9 9 9 9 9 9 9 9 9 7 1 7 7 7 7 7 7 7
7 7 7 7 1 9 9 9 9 9 9 9 9 9 9 9 7 9 9 9 9 9 9 9 9 9 9 9 9 9 9 7 7 7 7 7 7 7 7 7
7 7 7 7 1 1 1 1 9 9 9 9 9 9 7 7 7 9 9 9 9 9 9 9 9 9 9 9 9 9 9 9 7 7 7 7 7 7 7 7
7 7 7 7 1 1 1 1 1 1 9 9 7 7 7 9 9 9 9 9 9 9 9 9 9 9 9 9 9 9 9 1 7 7 7 7 7 7 7 7
7 7 7 7 1 0 1 1 1 1 7 7 7 9 9 9 9 9 9 7 9 9 9 7 7 7 9 9 9 9 1 1 1 7 7 7 7 7 7 7
7 7 7 7 1 9 1 1 1 1 7 9 9 9 9 9 9 7 7 7 9 9 9 9 9 7 7 9 9 9 1 1 1 7 7 7 7 7 7 7
7 7 7 7 1 1 1 1 1 1 7 9 9 9 9 9 9 7 9 9 9 9 9 9 9 9 7 7 9 1 1 1 1 7 7 7 7 7 7 7
7 7 7 7 1 1 1 1 1 1 7 9 9 9 9 9 9 7 9 9 9 9 9 9 9 9 9 7 1 1 1 1 1 7 7 7 7 7 7 7
7 7 7 7 7 7 7 7 7 7 7 9 9 9 9 9 9 7 9 9 9 9 9 9 9 9 9 7 1 1 1 1 1 7 7 7 7 7 7 7
7 7 7 7 7 9 9 9 9 9 9 9 9 9 9 9 9 7 9 9 9 9 9 9 9 9 9 7 1 1 1 1 1 7 7 7 7 7 7 7
7 7 9 9 7 9 9 9 9 9 9 9 9 9 9 9 9 7 9 9 9 9 9 9 9 9 9 7 1 1 1 1 1 7 7 7 7 7 7 7
7 7 9 9 7 9 9 9 9 9 9 9 9 9 9 9 9 7 9 9 9 9 9 9 9 9 9 7 3 1 1 1 1 7 7 7 7 7 7 7
7 7 7 7 7 9 9 9 9 9 9 9 9 9 9 9 7 7 9 9 9 9 9 9 9 9 9 7 7 1 1 1 1 7 7 7 7 7 7 7
7 7 7 7 7 9 9 9 9 9 9 9 9 9 9 7 7 9 9 9 9 9 9 9 9 9 9 9 7 1 1 1 3 7 7 7 7 7 7 7
7 7 7 7 7 7 7 9 9 9 9 9 9 7 7 7 9 9 9 9 9 9 9 9 9 9 9 9 7 7 7 3 9 9 9 7 7 7 7 7
7 7 7 7 9 9 7 7 7 7 7 7 7 7 9 9 9 9 9 9 9 9 9 9 9 9 9 9 9 9 7 7 7 7 9 7 7 7 7 7
7 7 7 7 7 7 9 9 9 9 9 9 9 9 9 9 9 9 9 9 9 9 9 9 9 9 9 9 9 9 9 9 9 7 9 7 7 7 7 7
7 7 7 7 7 7 9 9 9 9 9 9 9 9 9 9 9 9 9 9 9 9 9 9 9 9 9 9 9 9 9 9 9 7 3 7 7 7 7 7
7 7 7 7 7 7 9 9 9 9 9 9 9 9 9 9 9 7 7 7 7 7 7 7 7 7 7 9 9 9 9 9 9 7 9 7 7 7 7 7
7 7 7 7 7 7 9 9 9 9 9 9 9 9 9 9 9 7 7 7 7 7 7 7 7 7 7 9 9 9 9 9 9 7 9 7 7 7 7 7
7 7 7 7 7 7 9 9 9 7 7 7 7 7 7 7 7 7 7 7 7 7 7 7 7 7 7 9 9 9 9 9 9 7 9 7 7 7 7 7
7 7 7 7 7 7 6 6 6 7 7 7 7 7 7 7 7 7 7 7 7 7 7 7 7 7 7 6 6 6 6 6 6 7 9 7 7 7 7 7
