7 7 7 7 7 7 7 6 6 6 6 7 7 7 7 7 7 7 7 6 6 6 6 6 7 7 7 7 7 7 7 7 7 7 7 7 7 7 7 7
7 7 7 7 7 7 7 9 9 9 9 7 7 7 7 7 7 7 7 9 9 9 9 9 7 7 7 7 7 7 7 7 7 7 7 7 7 7 7 7
7 7 7 7 7 7 7 7 9 7 7 7 7 7 7 7 7 7 7 9 9 9 9 9 9 9 7 7 7 7 7 7 7 7 7 7 7 7 7 7
7 7 7 7 7 7 7 7 9 7 7 7 7 7 7 7 7 7 7 9 9 9 9 9 9 9 7 7 7 7 7 7 7 7 7 7 7 7 7 7
7 7 7 7 7 7 7 9 9 9 7 7 9 7 7 7 7 7 7 9 9 9 9 9 9 9 9 3 0 0 0 0 7 7 7 7 7 7 7 7
9 7 7 7 7 7 7 9 9 9 7 7 9 7 7 7 7 7 7 9 9 9 9 9 9 9 9 9 0 0 0 0 7 7 7 7 7 7 7 7
9 7 7 7 7 7 7 9 9 9 7 7 7 7 7 7 7 7 9 9 9 9 9 9 9 9 9 9 0 0 0 0 9 9 3 9 9 9 7 7
9 7 7 7 7 7 7 9 9 9 7 7 7 7 7 7 7 7 9 3 9 9 9 9 9 9 9 9 0 6 0 0 0 9 9 9 9 9 7 7
7 7 9 7 7 7 7 9 9 9 9 7 7 7 7 7 7 7 7 9 9 9 9 9 9 9 9 9 9 9 9 9 9 9 9 9 9 9 7 7
7 7 9 7 7 7 7 9 9 9 9 7 7 7 7 7 7 7 7 9 9 9 9 9 9 9 9 9 9 9 9 9 9 9 9 9 9 9 7 7
7 7 7 7 1 1 1 9 9 9 9 7 7 7 7 7 7 7 7 7 7 7 7 7 7 7 7 9 9 9 9 9 9 9 7 7 7 7 7 7
7 7 7 7 1 1 1 9 9 9 9 7 7 7 7 7 7 7 7 7 7 7 7 7 7 7 7 9 9 9 9 9 9 9 7 7 7 7 7 7
7 7 7 7 1 1 1 9 9 9 7 9 9 9 9 9 9 9 9 9 9 9 9 9 9 9 9 7 9 9 9 9 7 7 7 7 7 7 7 7
7 7 7 7 1 1 1 9 9 7 7 9 9 9 9 9 9 9 9 9 9 9 9 9 9 9 9 7 7 9 9 9 7 7 7 7 7 7 7 7
7 7 1 1 1 1 9 9 9 7 7 0 0 2 2 2 2 2 2 2 2 2 2 2 0 0 0 7 7 9 9 9 7 7 7 7 7 7 7 7
7 7 1 1 1 1 9 9 9 7 7 9 9 2 2 2 2 2 2 2 2 2 2 2 9 9 9 7 7 9 9 9 7 7 7 7 7 7 7 7
7 7 1 1 1 9 4 4 9 7 7 9 9 2 2 2 2 2 2 2 2 2 2 2 9 9 9 7 7 9 9 9 9 9 7 7 7 7 7 7
7 7 1 1 9 9 4 4 9 7 7 9 9 2 2 2 2 2 2 2 2 2 2 2 9 9 9 7 7 9 9 9 9 3 7 7 7 7 7 7
7 7 9 9 9 9 4 4 9 7 7 9 9 2 2 2 2 2 2 2 2 2 2 2 9 9 9 7 7 9 9 9 9 9 7 7 7 7 7 7
7 7 9 9 9 9 9 9 9 7 7 9 9 9 9 2 2 2 2 2 2 2 2 2 9 9 9 7 7 9 9 9 9 9 7 7 7 7 7 7
7 7 9 9 9 9 9 9 9 7 7 9 9 9 9 9 9 9 9 9 9 9 9 9 9 9 7 7 7 9 9 9 9 9 9 9 9 9 9 6
7 7 7 7 9 9 9 9 1 7 7 9 9 9 9 9 9 9 9 9 9 9 9 9 9 9 7 7 7 9 9 9 9 9 9 9 9 9 9 6
7 7 7 7 9 9 9 1 1 7 7 7 7 7 7 7 7 7 7 9 9 7 7 7 7 7 7 7 9 9 9 9 9 9 9 9 9 3 7 7
7 7 7 7 9 9 9 1 1 7 7 7 7 7 7 7 7 7 7 9 9 7 7 7 7 7 7 7 9 9 9 9 9 9 9 9 9 9 7 7
7 7 7 7 9 9 9 1 1 1 1 1 7 7 7 9 9 9 9 9 9 9 9 9 9 9 9 9 9 9 9 9 7 7 7 7 7 7 7 7
7 7 7 7 9 9 9 9 1 1 1 1 1 1 7 9 9 9 9 9 9 9 9 9 9 9 9 9 9 9 9 9 7 7 7 7 7 7 7 7
7 7 7 7 9 4 4 4 4 4 1 1 1 1 7 9 9 9 9 9 9 9 9 9 9 9 7 7 7 7 7 7 7 7 7 7 7 7 7 7
7 7 9 9 9 4 4 4 4 4 1 1 1 1 7 9 9 9 9 9 9 9 9 9 9 9 7 7 7 7 7 7 7 7 7 7 7 7 7 7
7 7 9 9 9 4 4 4 4 9 9 1 1 1 7 7 7 9 9 9 7 7 7 7 7 7 7 7 7 7 7 7 7 7 7 7 7 7 7 7
7 7 9 9 9 4 4 9 9 9 9 9 9 9 9 9 9 9 9 9 7 7 7 7 7 7 7 7 7 7 7 7 7 7 7 7 7 7 7 7
0 0 9 9 9 9 9 9 9 9 9 9 9 9 9 9 9 9 9 9 7 7 7 7 7 7 1 1 1 1 1 1 1 1 7 7 7 7 7 7
2 2 2 2 2 2 2 2 9 9 9 9 9 9 9 9 9 9 9 9 7 7 7 7 7 7 1 1 1 1 1 1 1 1 7 7 7 7 7 7
2 2 2 2 2 2 2 2 7 7 7 7 9 9 9 9 9 9 9 9 9 9 9 9 9 1 1 1 1 1 1 1 1 1 7 7 7 7 7 7
2 2 2 2 2 2 2 2 7 7 7 7 9 9 9 9 9 9 9 9 9 9 9 9 9 9 1 1 1 1 1 1 1 1 7 7 7 7 7 7
2 2 2 2 2 2 2 2 7 7 7 7 7 7 7 7 9 9 9 9 9 4 4 4 4 9 9 9 1 1 1 1 1 1 1 1 7 7 7 7
2 2 2 2 2 2 2 2 7 7 7 7 7 7 7 7 9 9 9 9 9 4 4 4 4 9 9 9 9 9 1 1 1 1 9 9 7 7 7 7
2 2 2 2 2 2 2 2 7 7 7 7 7 7 7 7 7 7 7 7 9 9 4 4 4 9 9 9 9 9 9 9 9 9 9 9 9 9 7 7
2 2 2 2 2 2 2 2 7 7 7 7 7 7 7 7 7 7 7 7 9 9 9 9 9 9 9 9 9 9 9 9 9 9 9 9 9 9 7 7
7 7 7 7 7 7 7 7 7 7 7 7 7 7 7 7 7 7 7 7 7 7 7 7 7 7 9 9 9 9 9 9 7 7 7 7 7 7 7 7
7 7 7 7 7 7 7 7 7 7 7 7 7 7 7 7 7 7 7 7 7 7 7 7 7 7 9 9 9 9 9 9 7 7 7 7 7 7 7 7
